0000000000000000000000000
            E            
00000000000000000000000 0
0                       0
0 00000000000000000000000
0         AAA           0
00000000000000000000000 0
0                       0
0 00000000000000000000000
            I            
0000000000000000000000000